1111111111111111111111
100000C0000010C0001011
111111111000100C000E01
1000CC00C00C10C0000C01
1000CC0000100000C00001
100000C000100000C00001
1000000000100111111101
1001111000100C00000C01
1001000000101111111001
10P1000000100000000001
1111100000000010000001
100000C00000C010000001
1C010C00C000C01CCCC001
1001001111100010C10001
10010000C0C10010010001
1111111111111111111111