1111111111111111111111
100000C0000010C0001011
111111111000100C000001
1000CC00C00C10C0000C01
1000CC0000100000C00001
100000C000100000C00001
1000000000100111111101
1101111000100C00000C01
1001000000101111111001
10P1000000100000000001
1111100000010010000001
100000C0001G1C01000001
1C010C00C001C01CCCC111
1001001111000010C10111
10010000CC0000100100E1
1111111111111111111111