11111111111111
10C0C010010001
1000CG10111101
11C00E0000CC01
1CCC000CC00001
1P000000000C01
11111111111111