11111111111111111111111111111111111111
100CCCCCCCCCCCCCCCC000000000CCCC000001
11111111111111111111100000000000000001
10000000000000000000000000CC0000000001
10000000000000111111111111111111111111
10000000000CC000CC00000000000000000001
1000000000000000000000000000CCCCC00001
1111111111111111111000000CCCCC00000001
1000000E000000000000000000000C000CC001
11111111111111111111100000000C0CC00001
10000000000000000000000000000C00G00001
10000000001001000100010000011111110001
10100100001001000100010000000001000001
101001000010010C0100110000000001000001
10100100001001000100000000111111111001
1010010CC010010000000CCC00000000001001
10100100C010000CC0000011111111110010C1
10100100C000000000P0000000000000001001
101C010CC00111111111111111100000001C01
10100100C00000000000000000000000001001
11111111111111111111111111111111111111